11 11
0 10
2 4
00010000010
11011101010
01000001010
01111111010
01000001010
01010111010
00010100010
00110101110
00010001000
11011111010
00000000010
